0x00,0x00,0x00,0x00,0x00,0x00,0x00,0x00,0x00,0x00,0x00,0x00,0x00,0x00,0x00,0x00,
0x07,0x00,0x1F,0x00,0x3F,0x00,0x7C,0x00,0x78,0x00,0xF0,0x00,0xE0,0x00,0xE0,0x00,
0x00,0xE0,0x00,0xD8,0x00,0x04,0x00,0x52,0x00,0x28,0x00,0x14,0x00,0x09,0x00,0x03,
0x07,0x00,0x1F,0x00,0x3F,0x00,0x7E,0x00,0x7E,0x00,0xFC,0x00,0xF8,0x00,0xE0,0x00,
0x00,0x00,0x00,0x3C,0x00,0x66,0x00,0x5E,0x00,0x5E,0x00,0x7E,0x00,0x3C,0x00,0x00,
0x00,0x03,0x00,0x11,0x00,0x24,0x00,0x4A,0x00,0x54,0x00,0x88,0x00,0xD0,0x00,0xC0,
0xE0,0x00,0xF8,0x00,0xFC,0x00,0x7E,0x00,0x7E,0x00,0x3F,0x00,0x1F,0x00,0x07,0x00,
0xE0,0x00,0xF8,0x00,0xFC,0x00,0x3E,0x00,0x1E,0x00,0x0F,0x00,0x07,0x00,0x07,0x00,
0x00,0xC0,0x00,0xD0,0x00,0x88,0x00,0x54,0x00,0x4A,0x00,0x24,0x00,0x11,0x00,0x03,
0xE0,0x00,0xE0,0x00,0xF0,0x00,0x78,0x00,0x7C,0x00,0x3F,0x00,0x1F,0x00,0x07,0x00,
0x00,0x03,0x00,0x09,0x00,0x14,0x00,0x28,0x00,0x52,0x00,0x04,0x00,0xD8,0x00,0xE0,
0x07,0x00,0x07,0x00,0x0F,0x00,0x1E,0x00,0x3E,0x00,0xFC,0x00,0xF8,0x00,0xE0,0x00,
