0xCD,0x01,0x02,0xD0,0x00,0xCE,0x01,0xD0,0x00,0xCF,0x01,0xD4,0x00,0xCA,0x01,0x02,
0xD6,0x00,0xC3,0x01,0xC2,0x00,0xC7,0x01,0x02,0xCC,0x00,0xC2,0x06,0xC8,0x00,0xC9,
0x01,0x02,0xCA,0x00,0xC2,0x06,0xCA,0x00,0xC8,0x01,0xD3,0x00,0xC2,0x06,0x00,0xC8,
0x01,0xD3,0x00,0xC2,0x06,0xC3,0x00,0xC2,0x01,0xE9,0x00,0x01,0x02,0xDC,0x00,0xC2,
0x01,0x02,0xDB,0x00,0xC4,0x01,0x02,0xC6,0x00,0x02,0xC8,0x01,0x02,0xC9,0x00,0xC5,
0x01,0xC6,0x07,0xCA,0x01,0x02,0xC8,0x00,0xC5,0x01,0xC6,0x07,0xC0,0x01,0xCF,0x01,
