0xFF,0x00,0xDB,0x00,0xC2,0x01,0xDC,0x00,0xC2,0x01,0xDC,0x00,0xC2,0x01,0xDC,0x00,
0xC2,0x01,0xDC,0x00,0xC2,0x01,0xD0,0x00,0xC6,0x05,0xC6,0x00,0xC2,0x01,0xD0,0x00,
0xC6,0x05,0xC6,0x00,0xC2,0x01,0xC6,0x00,0x02,0x01,0xD4,0x00,0xC2,0x01,0xDC,0x00,
0xC2,0x01,0xDC,0x00,0xC2,0x01,0xDC,0x00,0xC3,0x01,0xD0,0x00,0xC2,0x02,0xC9,0x00,
0xC3,0x01,0xCF,0x00,0x02,0xC2,0x01,0x02,0xC8,0x00,0xCB,0x01,0x02,0xC5,0x00,0x02,
0xC4,0x01,0x02,0xC7,0x00,0xD7,0x01,0xC4,0x00,0xC3,0x01,