0x00,0x00,0x00,0x00,0x00,0x00,0x00,0x00,0x00,0x00,0x00,0x00,0x00,0x00,0x00,0x00,
0x01,0x01,0x07,0x07,0x0F,0x0F,0x1F,0x1F,0x3F,0x3F,0x7D,0x7D,0x77,0x77,0xFD,0xFD,
0xFF,0xFF,0xFD,0xFD,0xEA,0xEA,0xBD,0xBD,0xEA,0xEA,0xF7,0xF7,0xA8,0xA8,0xD5,0xD5,
0x00,0x00,0xC0,0xC0,0xA0,0xA0,0xD0,0xD0,0xA8,0xA8,0x44,0x44,0xAA,0xAA,0x12,0x12,
0x00,0x00,0x00,0x00,0x00,0x00,0x00,0x00,0x01,0x01,0x03,0x03,0x07,0x07,0x0F,0x0F,
0x01,0x01,0x0F,0x0F,0x3F,0x3F,0xFB,0xFB,0xFF,0xFF,0xEA,0xEA,0xFD,0xFD,0xEA,0xEA,
0xC0,0xC0,0xF0,0xF0,0xF8,0xF8,0xAC,0xAC,0xF2,0xF2,0xA9,0xA9,0xD3,0xD3,0xA9,0xA9,
0x20,0x20,0x20,0x20,0x10,0x10,0x08,0x08,0x06,0x06,0x01,0x01,0x00,0x00,0x00,0x00,
0x13,0x13,0x29,0x29,0x10,0x10,0x00,0x00,0x02,0x02,0x80,0x80,0x70,0x70,0x0F,0x0F,
0xBB,0xBB,0x55,0x55,0x0B,0x0B,0x52,0x52,0x84,0x84,0x08,0x08,0x30,0x30,0xC0,0xC0,
0x00,0x00,0x01,0x01,0x07,0x07,0x0F,0x0F,0x1F,0x1F,0x3F,0x3F,0x7D,0x7D,0x7B,0x7B,
0x3F,0x3F,0xFF,0xFF,0xFD,0xFD,0xEA,0xEA,0xFD,0xFD,0xAA,0xAA,0xF7,0xF7,0xAA,0xAA,
0xF0,0xF0,0xFE,0xFE,0xED,0xED,0xBE,0xBE,0xD5,0xD5,0xA8,0xA8,0x17,0x17,0xEA,0xEA,
0x00,0x00,0x00,0x00,0x80,0x80,0xE0,0xE0,0x50,0x50,0x88,0x88,0x24,0x24,0x82,0x82,
0xEE,0xEE,0xDD,0xDD,0xAB,0xAB,0xD5,0xD5,0xBB,0xBB,0x51,0x51,0x66,0x66,0x35,0x35,
0xBE,0xBE,0x74,0x74,0xE9,0xE9,0xDC,0xDC,0xAA,0xAA,0xD4,0xD4,0x82,0x82,0x50,0x50,
0x81,0x81,0x29,0x29,0x11,0x11,0x01,0x01,0xA2,0xA2,0x42,0x42,0x02,0x02,0x04,0x04,
0x1F,0x1F,0x3E,0x3E,0x75,0x75,0x7F,0x7F,0x75,0x75,0xAE,0xAE,0xF4,0xF4,0xAA,0xAA,
0x5D,0x5D,0xFA,0xFA,0x55,0x55,0xAA,0xAA,0x71,0x71,0x2A,0x2A,0xC4,0xC4,0x80,0x80,
0x11,0x11,0xB5,0xB5,0x71,0x71,0x21,0x21,0x51,0x51,0x82,0x82,0x42,0x42,0x02,0x02,
0x00,0x00,0x03,0x03,0x07,0x07,0x0E,0x0E,0x1F,0x1F,0x3A,0x3A,0x77,0x77,0x7A,0x7A,
0xF8,0xF8,0xFC,0xFC,0xD6,0xD6,0xA1,0xA1,0x55,0x55,0x81,0x81,0x51,0x51,0x82,0x82,
0x0F,0x0F,0x3E,0x3E,0x77,0x77,0xFA,0xFA,0xD4,0xD4,0x60,0x60,0x34,0x34,0x0F,0x0F,
0xE0,0xE0,0xB8,0xB8,0x56,0x56,0x89,0x89,0x41,0x41,0x02,0x02,0x1C,0x1C,0xE0,0xE0,
0xD5,0xD5,0xA0,0xA0,0x83,0x83,0x46,0x46,0x21,0x21,0x18,0x18,0x07,0x07,0x00,0x00,
0x77,0x77,0xAE,0xAE,0x5D,0x5D,0x2A,0x2A,0x4D,0x4D,0x20,0x20,0x00,0x00,0xFF,0xFF,
0x44,0x44,0x88,0x88,0x42,0x42,0x80,0x80,0x00,0x00,0x00,0x00,0x00,0x00,0xFF,0xFF,
0x51,0x51,0x81,0x81,0x01,0x01,0x01,0x01,0x02,0x02,0x04,0x04,0x38,0x38,0xC0,0xC0,
0x1A,0x1A,0x14,0x14,0x0B,0x0B,0x05,0x05,0x02,0x02,0x01,0x01,0x00,0x00,0x00,0x00,
0x89,0x89,0x40,0x40,0x90,0x90,0x00,0x00,0x48,0x48,0x20,0x20,0xC1,0xC1,0x3E,0x3E,
0x04,0x04,0x08,0x08,0x08,0x08,0x10,0x10,0x20,0x20,0x40,0x40,0x80,0x80,0x00,0x00,
0xDD,0xDD,0xAA,0xAA,0xD0,0xD0,0x4A,0x4A,0x21,0x21,0x10,0x10,0x0C,0x0C,0x03,0x03,
0xC8,0xC8,0x94,0x94,0x08,0x08,0x00,0x00,0x40,0x40,0x01,0x01,0x0E,0x0E,0xF0,0xF0,
0xD5,0xD5,0xF8,0xF8,0xD4,0xD4,0xA0,0xA0,0x94,0x94,0x40,0x40,0x3F,0x3F,0x00,0x00,
0x02,0x02,0x84,0x84,0x04,0x04,0x08,0x08,0x10,0x10,0x60,0x60,0x80,0x80,0x00,0x00,
0x00,0x08,0x00,0x14,0x00,0x02,0x00,0x02,0x00,0x01,0x00,0x01,0x00,0x01,0x00,0x01,
0x00,0x00,0x00,0x00,0x00,0x0C,0x00,0x10,0x00,0x10,0x00,0x20,0x00,0x20,0x00,0x48,
0x00,0x00,0x03,0x00,0x0C,0x00,0x13,0x00,0x2E,0x00,0x2C,0x00,0x58,0x00,0x59,0x00,
0x00,0x00,0xE0,0x00,0x18,0x00,0xE4,0x00,0x3A,0x00,0x1E,0x00,0xCD,0x00,0xCF,0x00,
0xAA,0xAA,0xF6,0xF6,0x94,0x94,0x1C,0x1C,0x18,0x18,0x18,0x18,0x08,0x08,0x08,0x08,
0x6F,0x6F,0x69,0x69,0xE1,0xE1,0x61,0x61,0x61,0x61,0x60,0x60,0x60,0x60,0x40,0x40,
0x60,0x60,0x40,0x40,0xC0,0xC0,0x80,0x80,0x80,0x80,0x80,0x80,0x80,0x80,0x00,0x00,
0x5B,0x5B,0x5F,0x5F,0x36,0x36,0x36,0x36,0x36,0x36,0x2B,0x2B,0x2B,0x2B,0x2B,0x2B,
0x07,0x07,0x1F,0x1F,0x3B,0x3B,0x7D,0x7D,0x6A,0x6A,0x30,0x30,0x1A,0x1A,0x07,0x07,
0xFF,0xFF,0x75,0x75,0xBA,0xBA,0x54,0x54,0x22,0x22,0x00,0x00,0x20,0x20,0x80,0x80,
0x00,0x01,0x00,0x22,0x00,0x12,0x00,0x0C,0x00,0x14,0x00,0x56,0x00,0x3B,0x00,0x56,
0x00,0x50,0x00,0xD2,0x00,0xA4,0x00,0x94,0x00,0x49,0x00,0x95,0x00,0xB6,0x00,0xEB,
0x5E,0x00,0x58,0x00,0x59,0x00,0x2C,0x00,0x2E,0x00,0x17,0x00,0x0D,0x00,0x03,0x00,
0x3D,0x00,0x0F,0x00,0xCF,0x00,0xDE,0x00,0x3E,0x00,0xFC,0x00,0x78,0x00,0xE0,0x00,
0x00,0x00,0x00,0x80,0x00,0x40,0x00,0x20,0x00,0xA1,0x00,0x91,0x00,0x92,0x00,0x92,
0x00,0x00,0x00,0x00,0x00,0x00,0x00,0xC0,0x00,0x00,0x00,0x00,0x00,0x00,0x00,0x00,
0x40,0x40,0x40,0x40,0x40,0x40,0x40,0x40,0x40,0x40,0x00,0x00,0x40,0x40,0x00,0x00,
0x2B,0x2B,0x07,0x07,0x06,0x06,0x06,0x06,0x06,0x06,0x04,0x04,0x04,0x04,0x04,0x04,
0x10,0x10,0x10,0x10,0x10,0x10,0x10,0x10,0x10,0x10,0x00,0x00,0x10,0x10,0x00,0x00,
0x14,0x14,0x10,0x10,0x14,0x14,0x18,0x18,0x18,0x18,0x18,0x18,0x10,0x10,0x10,0x10,
0x30,0x30,0x7E,0x7E,0xFE,0xFE,0xCF,0xCF,0xA5,0xA5,0x68,0x68,0xAB,0xAB,0x9A,0x9A,
0x00,0x14,0x08,0x08,0x4C,0x4C,0xD4,0xD4,0xBA,0xBA,0xD5,0xD5,0xF9,0xF9,0x36,0x36,
0x38,0x38,0xDF,0xDF,0xDF,0xDF,0x7B,0x7B,0x52,0x52,0x8C,0x8C,0xD6,0xD6,0x54,0x54,
0x38,0x38,0x63,0x63,0xCB,0xCB,0xAF,0xAF,0xE7,0xE7,0x81,0x81,0x2A,0x2A,0xEC,0xEC,
0x00,0x00,0x00,0x80,0x00,0x40,0x00,0x20,0x00,0xA1,0x00,0x91,0x00,0x12,0x00,0x92,
0x00,0x00,0x00,0x00,0x00,0x01,0x00,0x02,0x00,0x07,0x00,0x05,0x00,0x2D,0x00,0x0E,
0x00,0x00,0x00,0x00,0x00,0x00,0x00,0x20,0x00,0x20,0x00,0x30,0x00,0x50,0x00,0x58,
0x04,0x04,0x04,0x04,0x08,0x08,0x30,0x30,0xC1,0xC1,0x03,0x03,0x07,0x07,0x0F,0x0F,
0x00,0x80,0x00,0x00,0x00,0x00,0x00,0x00,0x00,0x00,0x00,0x00,0x80,0x80,0xC0,0xC0,
0x00,0x2D,0x00,0x35,0x00,0x15,0x00,0x33,0x00,0x1A,0x00,0x15,0x00,0x0C,0x00,0x00,
0x00,0x78,0x00,0xB0,0x00,0x60,0x00,0xE8,0x00,0xC0,0x00,0xD0,0x00,0xA0,0x00,0x00,
0x0F,0x0F,0x1F,0x1F,0x3A,0x3A,0x7F,0x7F,0xEA,0xEA,0xFD,0xFD,0xDA,0xDA,0x7F,0x7F,
0xC0,0xC0,0x60,0x60,0xB0,0xB0,0x58,0x58,0xE6,0xE6,0x51,0x51,0x81,0x81,0xD1,0xD1,
0xE0,0xE0,0x60,0x60,0xA0,0xA0,0x40,0x40,0x80,0x80,0x00,0x00,0x00,0x00,0x00,0x00,
0x00,0x00,0x00,0x0F,0x00,0x07,0x00,0x00,0x00,0x03,0x00,0x00,0x00,0x07,0x00,0x00,
0x00,0x00,0x00,0x50,0x00,0xA0,0x00,0x00,0x00,0x40,0x00,0x00,0x00,0xA0,0x00,0x00,
0x04,0x04,0x04,0x04,0x08,0x08,0x13,0x13,0x67,0x67,0x8D,0x8D,0x12,0x12,0x11,0x11,
0x7E,0x7E,0x55,0x55,0x3E,0x3E,0x34,0x34,0x9A,0x9A,0xCC,0xCC,0xE6,0xE6,0x63,0x63,
0xA1,0xA1,0x52,0x52,0x04,0x04,0x88,0x88,0x10,0x10,0x10,0x10,0x20,0x20,0xC0,0xC0,
0x04,0x04,0x04,0x04,0x08,0x08,0x10,0x10,0x60,0x60,0x80,0x80,0x00,0x00,0x00,0x00,
0x00,0x01,0x00,0x03,0x00,0x03,0x00,0x00,0x00,0x01,0x00,0x03,0x00,0x01,0x00,0x00,
0x00,0x80,0x00,0x40,0x00,0xC0,0x00,0x00,0x00,0x80,0x00,0x40,0x00,0x80,0x00,0x00,
0x12,0x12,0x08,0x08,0x07,0x07,0x00,0x00,0x00,0x00,0x00,0x00,0x00,0x00,0x00,0x00,
0xA0,0xA0,0x40,0x40,0x80,0x80,0x00,0x00,0x00,0x00,0x00,0x00,0x00,0x00,0x00,0x00,
0x03,0x03,0x0F,0x0F,0x1F,0x1F,0x35,0x35,0x4F,0x4F,0x95,0x95,0xCB,0xCB,0x95,0x95,
0x80,0x80,0xF0,0xF0,0xFC,0xFC,0xDF,0xDF,0xFF,0xFF,0x57,0x57,0xBF,0xBF,0x57,0x57,
0x00,0x00,0x00,0x00,0x00,0x00,0x00,0x00,0x80,0x80,0xC0,0xC0,0xE0,0xE0,0xF0,0xF0,
0x88,0x88,0xAD,0xAD,0x8E,0x8E,0x84,0x84,0x8A,0x8A,0x41,0x41,0x42,0x42,0x40,0x40,
0xBA,0xBA,0x5F,0x5F,0xAA,0xAA,0x55,0x55,0x8E,0x8E,0x54,0x54,0x23,0x23,0x01,0x01,
0xF8,0xF8,0x7C,0x7C,0xAE,0xAE,0xFE,0xFE,0xAE,0xAE,0x75,0x75,0x2F,0x2F,0x55,0x55,
0x00,0x00,0x00,0x00,0x00,0x00,0x00,0x1C,0x00,0x2E,0x00,0x1E,0x00,0x03,0x00,0x81,
0x00,0x89,0x00,0x9A,0x00,0xD6,0x00,0x65,0x00,0x75,0x00,0xB7,0x00,0xDF,0x00,0x6B,
0x00,0x10,0x00,0x60,0x00,0xC0,0x00,0x80,0x00,0x90,0x00,0x20,0x00,0x20,0x00,0x40,
0x00,0x03,0x00,0x1C,0x00,0xE5,0x00,0x12,0x00,0x40,0x00,0x00,0x00,0x00,0x00,0x00,
0x00,0xC0,0x00,0x38,0x00,0x27,0x00,0x41,0x00,0x04,0x00,0x00,0x00,0x00,0x00,0x00,
0x00,0x03,0x00,0x1C,0x00,0xE9,0x00,0x40,0x00,0x10,0x00,0x00,0x00,0x00,0x00,0x00,
0x00,0xC0,0x00,0x38,0x00,0x47,0x00,0x12,0x00,0x04,0x00,0x00,0x00,0x00,0x00,0x00,
0x00,0x7A,0x00,0x1D,0x00,0x07,0xE0,0xE0,0xB8,0xB8,0x56,0x56,0x89,0x89,0x41,0x41,
0x00,0xD0,0x00,0xD0,0x00,0x54,0x00,0x34,0x00,0x0F,0x00,0xB1,0x00,0x5A,0x00,0xAD,
0x00,0x02,0x00,0x02,0x00,0x0A,0x00,0x52,0x00,0x24,0x00,0x65,0x00,0x95,0x00,0x6A,
0x00,0x10,0x00,0x20,0x00,0x44,0x00,0x55,0x00,0x92,0x00,0x92,0x00,0x5D,0x00,0xED,
0x00,0x10,0x00,0x52,0x00,0x4A,0x00,0xCA,0x00,0x45,0x00,0x55,0x00,0xCB,0x00,0x75,
0x00,0x00,0x0F,0x0F,0x1F,0x1F,0x3F,0x3F,0x75,0x75,0x7B,0x7B,0xD5,0xD5,0xFE,0xFE,
0x00,0x00,0xC0,0xC0,0x60,0x60,0xB0,0xB0,0x58,0x58,0xA8,0xA8,0x54,0x54,0x8C,0x8C,
0x01,0x01,0x03,0x03,0x07,0x07,0x0F,0x0F,0x1F,0x1F,0x3A,0x3A,0x3D,0x3D,0x6E,0x6E,
0xC0,0xC0,0xE0,0xE0,0x50,0x50,0xE8,0xE8,0x58,0x58,0xA4,0xA4,0x04,0x04,0xA2,0xA2,
0x04,0x04,0x08,0x08,0x08,0x08,0x10,0x10,0x21,0x21,0x47,0x47,0x8F,0x8F,0x1D,0x1D,
0x00,0x00,0x00,0x00,0x00,0x00,0x00,0x00,0xF0,0xF0,0xF8,0xF8,0xAC,0xAC,0x42,0x42,
0x55,0x55,0x3A,0x3A,0x15,0x15,0x0E,0x0E,0x03,0x03,0x01,0x01,0x00,0x00,0x00,0x00,
0x52,0x52,0x06,0x06,0x51,0x51,0x01,0x01,0x41,0x41,0x81,0x81,0x62,0x62,0x1C,0x1C,
0x00,0x00,0x00,0x00,0x00,0x00,0x00,0x00,0x03,0x03,0x0F,0x0F,0x3E,0x3E,0x7F,0x7F,
0x00,0x00,0x00,0x00,0x00,0x00,0x70,0x70,0xFC,0xFC,0xFE,0xFE,0xEB,0xEB,0xFC,0xFC,
0x75,0x75,0x6B,0x6B,0x5D,0x5D,0x2A,0x2A,0x34,0x34,0x1A,0x1A,0x08,0x08,0x87,0x87,
0xC2,0xC2,0xA2,0xA2,0x02,0x02,0x82,0x82,0x04,0x04,0x08,0x08,0x10,0x10,0xE0,0xE0,
0x3E,0x3E,0x75,0x75,0xEE,0xEE,0xF5,0xF5,0xAA,0xAA,0xF1,0xF1,0xA8,0xA8,0x40,0x40,
0xAA,0xAA,0x02,0x02,0xA2,0xA2,0x04,0x04,0x04,0x04,0x08,0x08,0x08,0x08,0x10,0x10,
0x00,0x00,0x01,0x01,0x03,0x03,0x07,0x07,0x0F,0x0F,0x1D,0x1D,0x1F,0x1F,0x1D,0x1D,
0xFA,0xFA,0xFF,0xFF,0xFA,0xFA,0xD7,0xD7,0xBE,0xBE,0x55,0x55,0xEA,0xEA,0x5C,0x5C,
0xAA,0xAA,0x74,0x74,0xAA,0xAA,0x44,0x44,0xAD,0xAD,0x5C,0x5C,0x88,0x88,0x54,0x54,
0x40,0x40,0xC0,0xC0,0x40,0x40,0x43,0x43,0x47,0x47,0x4F,0x4F,0x4D,0x4D,0x40,0x40,
0x00,0x00,0x00,0x00,0xFE,0xFE,0xEB,0xEB,0x75,0x75,0xA8,0xA8,0x44,0x44,0x00,0x00,
0x1A,0x1A,0x14,0x14,0x0B,0x0B,0x85,0x85,0x62,0x62,0x91,0x91,0x10,0x10,0x00,0x00,
0x00,0x00,0xFD,0xFD,0x27,0x27,0x02,0x02,0x02,0x02,0x02,0x02,0x00,0x00,0x00,0x00,
0x00,0x00,0xEE,0xEE,0x11,0x11,0x00,0x00,0x00,0x00,0x00,0x00,0x00,0x00,0x00,0x00,
0xEA,0xEA,0xB7,0xB7,0x14,0x14,0x1C,0x1C,0x0C,0x0C,0x0C,0x0C,0x08,0x08,0x08,0x08,
0x36,0x36,0xF9,0xF9,0xD5,0xD5,0xBA,0xBA,0xD4,0xD4,0x4C,0x4C,0x08,0x08,0x00,0x00,
