0xD7,0x01,0xC4,0x00,0xDA,0x01,0xC4,0x00,0xC9,0x01,0x00,0xC3,0x01,0x00,0xCC,0x01,
0xC5,0x00,0xC6,0x01,0xCA,0x00,0xC9,0x01,0xC5,0x00,0xC6,0x01,0xC4,0x00,0xC4,0x06,
0xC2,0x00,0xC7,0x01,0xC7,0x00,0x01,0x00,0xC2,0x01,0xCD,0x00,0xC5,0x01,0xCA,0x00,
0x01,0xDD,0x00,0x01,0xDD,0x00,0x01,0xC6,0x00,0xC3,0x01,0xD4,0x00,0x01,0x02,0xCE,
0x00,0xC4,0x06,0xCA,0x00,0xC2,0x01,0xD9,0x00,0x02,0xC5,0x01,0x02,0xD4,0x00,0x02,
0xC9,0x01,0xD3,0x00,0x02,0xCB,0x01,0xC6,0x00,0xC2,0x02,0xC9,0x00,0x02,0xCD,0x01,
0x02,0xC3,0x00,0x02,0xC4,0x01,0x02,0xC5,0x00,0x02,0xCF,0x01,0xC2,0x02,0xF3,0x01,
