0xC9,0x00,0x01,0x02,0x03,0x04,0x05,0xCD,0x00,0x06,0x07,0x08,0xC8,0x00,0x09,0x0A,
0x0B,0x0C,0x0D,0x05,0xCD,0x00,0x06,0x0E,0x0F,0xC2,0x00,0x10,0x11,0x12,0x13,0xC2,
0x00,0x14,0x15,0x16,0x17,0x18,0x05,0x19,0xCC,0x00,0x06,0x1A,0x1B,0xC2,0x00,0x1C,
0x1D,0x1E,0x1F,0x20,0xC2,0x00,0x01,0x21,0x22,0x23,0x24,0x25,0xCC,0x00,0x06,0x26,
0x17,0xC2,0x00,0x27,0x28,0x29,0x2A,0x2B,0x2C,0x2D,0x01,0x02,0x03,0x04,0x2E,0x12,
0xCC,0x00,0x06,0x07,0x08,0xC3,0x00,0x10,0x11,0x12,0x2F,0x30,0x31,0x01,0x0B,0x0C,
0x0D,0x32,0x1E,0xCC,0x00,0x06,0x0E,0x0F,0xC3,0x00,0x1C,0x1D,0x1E,0x00,0x33,0x34,
0x35,0x16,0x17,0x18,0x36,0x29,0xC8,0x00,0x37,0xC3,0x38,0x39,0x1A,0x1B,0xC3,0x00,
0x27,0x28,0x29,0xC3,0x00,0x01,0x21,0x22,0x23,0x05,0x00,0x3A,0x3B,0xC6,0x00,0x3C,
0x3D,0x3E,0x3F,0x40,0x26,0x17,0xC9,0x00,0x01,0x02,0x03,0x04,0x41,0x42,0x43,0xC7,
0x00,0x44,0xC3,0x45,0x46,0x07,0x08,0xC6,0x00,0x47,0x48,0x49,0x01,0x0B,0x0C,0x0D,
0x4A,0x4B,0xC4,0x00,0xC9,0x4C,0x4D,0x0F,0xC6,0x00,0x4E,0x4F,0x50,0x01,0x16,0x17,
0x18,0x05,0xCC,0x00,0x51,0x52,0x53,0x1B,0xC6,0x00,0x54,0x55,0x56,0x01,0x21,0x22,
0x23,0x05,0xCC,0x00,0x57,0x58,0x59,0x17,0xC6,0x00,0xC9,0x4C,0xCC,0x00,0x06,0x07,
0x08,0xC9,0x00,0x01,0x0B,0x0C,0x0D,0x05,0xCD,0x00,0x06,0x0E,0x0F,0xC4,0x00,0x5A,
0x5B,0x5C,0x5B,0x5D,0x01,0x16,0x17,0x18,0x05,0x00,0x5A,0x5B,0x5C,0x5B,0x5E,0xC7,
0x00,0x06,0x1A,0x1B,0xC4,0x00,0x5F,0x00,0x5F,0x00,0x5F,0x01,0x21,0x22,0x23,0x05,
0x00,0x5F,0x00,0x5F,0x00,0x60,0x61,0x62,0xC5,0x00,0x39,0x26,0x17,0x00,0xD4,0x4C,
0x63,0xC6,0x00,0x07,0x08,