0xC9,0x00,0x01,0x02,0x03,0x04,0x05,0xCB,0x00,0x06,0x07,0x08,0x09,0x0A,0xC8,0x00,
0x0B,0x0C,0x0D,0x0E,0x0F,0x05,0xCB,0x00,0x06,0x07,0x08,0x10,0x11,0xC2,0x00,0x12,
0x13,0x00,0x14,0xC2,0x00,0x15,0x16,0x17,0x18,0x19,0x05,0x1A,0xCA,0x00,0x06,0x07,
0x08,0x1B,0x1C,0xC2,0x00,0x1D,0x1E,0x1F,0x20,0x21,0xC2,0x00,0x01,0x22,0x23,0x24,
0x25,0x26,0xCA,0x00,0x06,0x07,0x08,0x27,0x18,0xC2,0x00,0x28,0x29,0x00,0x2A,0x2B,
0x2C,0x2D,0x01,0x02,0x03,0x04,0x2E,0x2F,0xCA,0x00,0x06,0x07,0x30,0x09,0x0A,0xC3,
0x00,0x31,0x32,0x33,0x34,0x35,0x36,0x01,0x0D,0x0E,0x0F,0x37,0x38,0x39,0xC9,0x00,
0x06,0x07,0x00,0x10,0x11,0xC3,0x00,0x3A,0x3B,0x3C,0x00,0x3D,0x3E,0x3F,0x17,0x18,
0x19,0x40,0x41,0x42,0xC7,0x00,0x43,0x44,0x45,0x46,0x47,0x1B,0x1C,0xC3,0x00,0x48,
0x49,0x4A,0xC3,0x00,0x01,0x22,0x23,0x24,0x05,0x00,0x4B,0x4C,0xC6,0x00,0x4D,0x4E,
0x4F,0x50,0x51,0x27,0x18,0xC9,0x00,0x01,0x02,0x03,0x04,0x52,0x53,0x54,0xC7,0x00,
0x55,0xC3,0x56,0x57,0x09,0x0A,0xC6,0x00,0x58,0x59,0x5A,0x01,0x0D,0x0E,0x0F,0x5B,
0x5C,0xC4,0x00,0xC9,0x5D,0x5E,0x11,0xC6,0x00,0x5F,0x60,0x61,0x01,0x17,0x18,0x19,
0x05,0xCC,0x00,0x62,0x63,0x64,0x1C,0xC6,0x00,0x65,0x66,0x67,0x01,0x22,0x23,0x24,
0x05,0xCC,0x00,0x68,0x69,0x6A,0x18,0xC6,0x00,0xC9,0x5D,0xCC,0x00,0x6B,0x09,0x0A,
0x00,0x6C,0xC2,0x6D,0xC5,0x00,0x01,0x0D,0x0E,0x0F,0x05,0xCD,0x00,0x6B,0x10,0x11,
0x00,0x6E,0x6F,0x6E,0x70,0x71,0x72,0x71,0x73,0x01,0x17,0x18,0x19,0x05,0x00,0x70,
0x71,0x72,0x71,0x74,0xC7,0x00,0x6B,0x1B,0x1C,0x00,0x6C,0xC2,0x6D,0x75,0x00,0x75,
0x00,0x75,0x01,0x22,0x23,0x24,0x05,0x00,0x75,0x00,0x75,0x00,0x76,0x77,0x78,0xC5,
0x00,0x79,0x27,0x18,0x00,0xD4,0x5D,0x7A,0xC6,0x00,0x09,0x0A,