0xDC,0x00,0xC2,0x01,0xDC,0x00,0xC2,0x01,0xDC,0x00,0xC2,0x01,0xDC,0x00,0xC2,0x01,
0xDC,0x00,0xC2,0x01,0xDC,0x00,0xC2,0x01,0xD7,0x00,0xC5,0x04,0xC2,0x01,0xD7,0x00,
0xC5,0x04,0xC2,0x01,0xD7,0x00,0xC5,0x04,0xC2,0x01,0xD3,0x00,0x02,0xCA,0x01,0xDC,
0x00,0xC2,0x01,0xDC,0x00,0xC2,0x01,0xC6,0x00,0x02,0xC7,0x01,0x02,0xCD,0x00,0xC2,
0x01,0xDC,0x00,0xC2,0x01,0xDC,0x00,0xC2,0x01,0xDC,0x00,0xC2,0x01,0x00,0x02,0xD2,
0x01,0x02,0xC7,0x00,0xC2,0x01,