0x00,0x00,0x00,0x00,0x00,0x00,0x00,0x00,0x00,0x00,0x00,0x00,0x00,0x00,0x00,0x00,
0x00,0x31,0x00,0x54,0x00,0x66,0x00,0x0B,0x00,0x01,0x00,0x14,0x00,0x06,0x00,0x0B,
0x08,0x88,0x01,0xC1,0x08,0x68,0x01,0x01,0x08,0x48,0x01,0xA1,0x08,0x48,0x01,0x61,
0x3A,0x3A,0x46,0x46,0x2A,0x2A,0x16,0x16,0x22,0x22,0x17,0x17,0x32,0x32,0x57,0x57,
0xFA,0xFA,0x5F,0x5F,0xFA,0xFA,0x5F,0x5F,0xFA,0xFA,0x4F,0x4F,0xEA,0xEA,0x4F,0x4F,
0x66,0x66,0x54,0x54,0x6A,0x6A,0x54,0x54,0x66,0x66,0x54,0x54,0xE6,0xE6,0x54,0x54,
0x80,0x80,0x10,0x10,0x80,0x80,0x10,0x10,0x80,0x80,0x10,0x10,0x80,0x80,0x10,0x10,
0x38,0x00,0x54,0x00,0xAA,0x00,0xD2,0x00,0x82,0x00,0x44,0x00,0x38,0x00,0x00,0x00,
0x0A,0x0A,0x01,0x01,0x0A,0x0A,0x03,0x03,0x0A,0x0A,0x02,0x02,0x0A,0x0A,0x02,0x02,
0xFA,0xFA,0x5F,0x5F,0xFA,0xFA,0x5B,0x5B,0xFA,0xFA,0x5F,0x5F,0xEA,0xEA,0x4F,0x4F,
0x00,0x00,0x00,0x00,0x00,0x00,0x00,0x00,0x00,0x00,0x20,0x20,0x40,0x40,0x40,0x40,
0x08,0xA8,0x01,0xC1,0x08,0x08,0x01,0x41,0x08,0x88,0x01,0x41,0x08,0x68,0x01,0x21,
0x3A,0x3A,0x47,0x47,0x2A,0x2A,0x27,0x27,0x2A,0x2A,0x27,0x27,0x32,0x32,0x57,0x57,
0xEA,0xEA,0x4F,0x4F,0xFA,0xFA,0x5F,0x5F,0xFA,0xFA,0x4F,0x4F,0xEA,0xEA,0x4F,0x4F,
0xEA,0xEA,0x54,0x54,0x62,0x62,0x54,0x54,0xEE,0xEE,0x54,0x54,0xEA,0xEA,0x54,0x54,
0x80,0x80,0x10,0x10,0x80,0x80,0x10,0x10,0x80,0x80,0x10,0x10,0x81,0x81,0x13,0x13,
0x00,0x00,0x10,0x10,0xA0,0xA0,0x40,0x40,0x40,0x40,0x98,0x98,0x70,0x70,0x80,0x80,
0x00,0x00,0x30,0x00,0x28,0x00,0x30,0x00,0x2A,0x00,0x33,0x00,0x28,0x00,0x30,0x00,
0x00,0x00,0x00,0x00,0x00,0x00,0x00,0x00,0x00,0x00,0x01,0x00,0xDB,0x00,0x6C,0x00,
0x00,0x00,0x30,0x00,0x28,0x00,0x30,0x00,0xAA,0x00,0xB3,0x00,0x28,0x00,0x30,0x00,
0x0A,0x0A,0x01,0x01,0x0A,0x0A,0x01,0x01,0x0A,0x0A,0x02,0x02,0xCA,0x0A,0x61,0x01,
0xEA,0xEA,0x4F,0x4F,0xFA,0xFA,0x5F,0x5F,0xFA,0xFA,0x5B,0x5B,0xFA,0xFA,0x5B,0x5B,
0x06,0x06,0x03,0x03,0x01,0x01,0x00,0x00,0x00,0x00,0x00,0x00,0x00,0x00,0x00,0x00,
0x80,0x80,0x80,0x80,0x80,0x80,0xC0,0xC0,0x60,0x60,0x70,0x70,0x38,0x38,0x2C,0x2C,
0x08,0x08,0x01,0x41,0x08,0x88,0x01,0xE1,0x08,0x08,0x01,0x21,0x08,0x08,0x01,0x01,
0x22,0x22,0x17,0x17,0x2A,0x2A,0x17,0x17,0x2A,0x2A,0x57,0x57,0x22,0x22,0x57,0x57,
0xFA,0xFA,0x5F,0x5F,0xEA,0xEA,0x4F,0x4F,0xEA,0xEA,0x4F,0x4F,0xEA,0xEA,0x5F,0x5F,
0x66,0x66,0x54,0x54,0x66,0x66,0x54,0x54,0xEA,0xEA,0x54,0x54,0xE6,0xE6,0x54,0x54,
0x85,0x85,0x12,0x12,0x84,0x84,0x10,0x10,0x80,0x80,0x10,0x10,0x80,0x80,0x10,0x11,
0x28,0x00,0x30,0x00,0x28,0x00,0x30,0x00,0x28,0x00,0x30,0x00,0x28,0x00,0x00,0x00,
0x0A,0x0A,0x01,0x01,0x0A,0x0A,0x02,0x02,0x0A,0x0A,0x02,0x02,0x0A,0x0A,0x00,0x00,
0xFA,0xFA,0x4F,0x4F,0xEA,0xEA,0x5F,0x5F,0xFA,0xFA,0x5F,0x5F,0xFA,0xFA,0x53,0x53,
0x00,0x00,0x00,0x00,0x00,0x00,0x00,0x00,0x00,0x10,0x00,0x9B,0x00,0x2D,0x00,0xD0,
0x01,0x01,0x02,0x02,0x00,0x00,0x00,0x00,0x00,0x00,0x00,0x00,0x00,0x80,0x00,0x40,
0xE6,0xE6,0x1B,0x1B,0x0D,0x0D,0x06,0x06,0x04,0x04,0x03,0x03,0x21,0x21,0x10,0x10,
0x10,0x10,0x30,0x30,0xB0,0xB0,0xF0,0xF0,0x70,0x70,0x2C,0x2C,0x16,0x16,0x8F,0x8F,
0x08,0x08,0x01,0x01,0x08,0x08,0x01,0x01,0x08,0x08,0x01,0x01,0x08,0x08,0x01,0x01,
0x22,0x22,0x57,0x57,0x32,0x32,0x56,0x56,0x32,0x32,0x57,0x57,0x32,0x32,0x16,0x16,
0xFA,0xFA,0x5F,0x5F,0xFA,0xFA,0x5F,0x5F,0xEA,0xEA,0x4F,0x4F,0xEA,0xEA,0x5F,0x5F,
0x62,0x62,0x5C,0x5C,0xEA,0xEA,0x54,0x54,0xE2,0xE2,0x54,0x54,0x66,0x66,0x54,0x54,
0x80,0x83,0x10,0x14,0x80,0x84,0x10,0x11,0x80,0x84,0x10,0x16,0x80,0x84,0x10,0x11,
0x00,0x2B,0x00,0x1C,0x00,0xC2,0x00,0x31,0x00,0x4A,0x00,0x2D,0x00,0xD0,0x00,0x9A,
0x00,0x00,0x00,0x00,0x00,0x40,0x00,0xA0,0x00,0x80,0x00,0x20,0x00,0x60,0x00,0xD0,
0x2A,0x0A,0x41,0x01,0xAA,0x0A,0xC1,0x01,0x8A,0x0A,0x41,0x01,0x2A,0x0A,0x01,0x01,
0x00,0x07,0x00,0x04,0x00,0x02,0x00,0x0D,0x00,0x08,0x00,0x03,0x00,0x04,0x00,0x02,
0x00,0x00,0x00,0xA0,0x00,0x00,0x03,0xB3,0x00,0x60,0x00,0xB0,0x00,0x40,0x00,0x00,
0x09,0x09,0x1F,0x1F,0x60,0x60,0x80,0x80,0x00,0x00,0x00,0x00,0x00,0x00,0x00,0x00,
0x43,0x43,0xA1,0xA1,0x70,0x70,0x0C,0x0C,0x02,0x02,0x01,0x01,0x00,0x00,0x00,0x00,
0x88,0x88,0x61,0x61,0xA8,0xA8,0x41,0x41,0x28,0x28,0x01,0x01,0x88,0x88,0x61,0x61,
0x80,0x81,0x10,0x14,0x80,0x81,0x10,0x16,0x80,0x80,0x10,0x10,0x80,0x85,0x10,0x14,
0x00,0xA0,0x00,0x00,0x00,0xA0,0x00,0xC0,0x00,0x40,0x00,0x30,0x00,0xA0,0x00,0x00,
0x00,0x00,0x00,0x00,0x00,0x00,0x3C,0x00,0x7E,0x00,0x7E,0x00,0x3C,0x00,0x00,0x00,
0x00,0x37,0x00,0x00,0x00,0xCD,0x00,0x91,0x00,0x00,0x00,0x00,0x00,0x00,0x00,0x00,
0x00,0x40,0x00,0xE0,0x00,0x00,0x00,0x00,0x00,0x00,0x00,0x00,0x00,0x00,0x00,0x00,
0x28,0x28,0x01,0x01,0x08,0x08,0x01,0x01,0x08,0x08,0x01,0x01,0x08,0x08,0x01,0x81,
0x80,0x81,0x10,0x13,0x80,0x82,0x10,0x10,0x80,0x86,0x10,0x15,0x80,0x80,0x10,0x13,
0x00,0x20,0x00,0x5C,0x00,0x30,0x00,0x00,0x00,0x00,0x00,0x00,0x00,0x00,0x00,0x40,
0x10,0x00,0x18,0x00,0x18,0x00,0x18,0x00,0x18,0x00,0x18,0x00,0x18,0x00,0x18,0x00,
0x00,0x00,0x00,0x00,0x00,0x18,0x00,0x04,0x00,0x04,0x00,0x02,0x00,0x02,0x00,0x09,
0x00,0x08,0x00,0x14,0x00,0x20,0x00,0x20,0x00,0x40,0x00,0x40,0x00,0x40,0x00,0x40,
0x00,0x00,0x00,0x00,0x00,0x02,0x00,0x05,0x00,0x01,0x00,0x04,0x00,0x06,0x00,0x0B,
0x08,0xC8,0x01,0x21,0x08,0x28,0x01,0x81,0x08,0x28,0x01,0x61,0x08,0x28,0x01,0x81,
0x80,0x84,0x10,0x10,0x80,0x85,0x10,0x16,0x80,0x82,0x10,0x14,0x80,0x83,0x10,0x15,
0x18,0x00,0x18,0x00,0x18,0x00,0x18,0x00,0x18,0x00,0x18,0x00,0x18,0x00,0x00,0x00,
0x00,0x05,0x00,0x25,0x00,0x12,0x00,0x14,0x00,0xC9,0x00,0x54,0x00,0xB6,0x00,0x6B,
0x00,0x40,0x00,0xA2,0x00,0xA4,0x00,0x98,0x00,0x14,0x00,0xB5,0x00,0xEE,0x00,0xB5,
0x00,0x01,0x00,0x04,0x00,0x06,0x00,0x0B,0x00,0x0C,0x00,0x01,0x00,0x01,0x00,0x02,
0x08,0x88,0x01,0x21,0x08,0x88,0x01,0x61,0x08,0x08,0x01,0x01,0x08,0xA8,0x01,0x21,
0x80,0x80,0x10,0x16,0x80,0x85,0x10,0x12,0x80,0x84,0x10,0x14,0x80,0x80,0x10,0x10,
0x01,0x00,0x03,0x00,0x02,0x00,0x05,0x00,0x05,0x00,0x0A,0x00,0x0B,0x00,0x1A,0x00,
0x3B,0x00,0x56,0x00,0xD4,0x00,0xF5,0x00,0xB5,0x00,0xB5,0x00,0xD6,0x00,0xDE,0x00,
0x77,0x00,0x8B,0x00,0xB7,0x00,0xAA,0x00,0xAA,0x00,0xAA,0x00,0xEE,0x00,0xDD,0x00,
0x4A,0x0A,0x41,0x01,0xCA,0x0A,0xE3,0x03,0xEA,0x0A,0x62,0x02,0x6A,0x0A,0x42,0x02,
0x00,0x00,0x00,0x00,0x00,0x00,0x00,0x00,0x00,0x00,0x41,0x41,0x23,0x23,0x2E,0x2E,
0x00,0x00,0x01,0x01,0x07,0x07,0x1A,0x1A,0x74,0x74,0xA0,0xA0,0x40,0x40,0xB8,0xB8,
0x70,0x70,0xC0,0xC0,0x00,0x00,0x00,0x00,0x00,0x00,0x00,0x00,0x00,0x00,0x00,0x00,
0x12,0x00,0x1A,0x00,0x35,0x00,0x35,0x00,0x25,0x00,0x2D,0x00,0x25,0x00,0x55,0x00,
0xAA,0x00,0xBA,0x00,0xAA,0x00,0xAB,0x00,0xAA,0x00,0xA2,0x00,0xA2,0x00,0x22,0x00,
0x55,0x00,0x55,0x00,0x55,0x00,0x6A,0x00,0x6A,0x00,0x6A,0x00,0x22,0x00,0x20,0x00,
0x80,0x80,0x10,0x10,0x80,0x80,0x11,0x11,0x87,0x87,0x12,0x12,0x85,0x85,0x12,0x12,
0x35,0x35,0x68,0x68,0xD0,0xD0,0xA0,0xA0,0x40,0x40,0x80,0x80,0x00,0x00,0x00,0x00,
0x55,0x00,0x6D,0x00,0x6D,0x00,0x25,0x00,0xAD,0x00,0xED,0x00,0xAB,0x00,0xAB,0x00,
0x84,0x84,0x10,0x10,0x80,0x80,0x10,0x10,0x80,0x80,0x10,0x10,0x80,0x80,0x10,0x10,
0xFF,0x00,0xAF,0x00,0xDA,0x00,0xAE,0x00,0x0A,0x00,0x10,0x00,0x00,0x00,0x00,0x00,
0xFF,0x00,0xBF,0x00,0xEA,0x00,0xA7,0x00,0x7A,0x68,0x55,0x55,0x72,0x72,0x55,0x55,
0xFF,0x00,0xEB,0x00,0xBA,0x00,0x28,0x00,0x47,0x46,0x55,0x55,0x70,0x70,0x55,0x55,
0xEA,0x0A,0xE1,0x01,0xAA,0x0A,0x02,0x02,0x6A,0x6A,0x42,0x42,0x6A,0x6A,0x40,0x40,
0x70,0x70,0x55,0x55,0x78,0x78,0x55,0x55,0x7C,0x7C,0x55,0x55,0x6C,0x6C,0x45,0x45,
0x00,0x00,0x7F,0x00,0x7F,0x00,0x2A,0x00,0x00,0x00,0x70,0x00,0x60,0x00,0x30,0x00,
0x00,0x00,0xEF,0x00,0xFF,0x00,0xAA,0x00,0x00,0x00,0x07,0x00,0x06,0x00,0x0F,0x00,
0x78,0x78,0x55,0x55,0x7A,0x7A,0x55,0x55,0x66,0x66,0x55,0x55,0x66,0x66,0x55,0x55,
0x00,0x00,0x55,0x00,0xFF,0x00,0xFF,0x00,0x00,0x00,0x60,0x00,0xE0,0x00,0x60,0x00,
0x6A,0x6A,0x41,0x41,0x6A,0x6A,0x41,0x41,0x6A,0x6A,0x41,0x41,0x6A,0x6A,0x41,0x41,
0x00,0x00,0x03,0x03,0x0F,0x0F,0x1F,0x1F,0x3F,0x3F,0x7F,0x7F,0x7E,0x7E,0x7D,0x7D,
0x00,0x00,0xFE,0xFE,0xA1,0xA1,0xC0,0xC0,0xA8,0xA8,0x45,0x45,0xA8,0xA8,0xD5,0xD5,
0x00,0x00,0x00,0x00,0x80,0x80,0x40,0x40,0x20,0x20,0x10,0x10,0x10,0x10,0x10,0x10,
0x6E,0x6E,0x41,0x41,0x6A,0x6A,0x51,0x51,0x7A,0x7A,0x55,0x55,0x6C,0x6C,0x45,0x45,
0x60,0x00,0x70,0x00,0x60,0x00,0x00,0x00,0x7E,0x00,0x7F,0x00,0x2A,0x00,0x00,0x00,
0x06,0x00,0x07,0x00,0x06,0x00,0x00,0x00,0xFF,0x00,0xFF,0x00,0xAA,0x00,0x00,0x00,
0x66,0x66,0x55,0x55,0x46,0x46,0x55,0x55,0x3A,0x3A,0x55,0x55,0x7E,0x7E,0x55,0x55,
0x00,0x00,0x7E,0x00,0x7F,0x00,0x2A,0x00,0x00,0x00,0x70,0x00,0x60,0x00,0x30,0x00,
0x00,0x00,0xFF,0x00,0xFF,0x00,0xAA,0x00,0x00,0x00,0x07,0x00,0x06,0x00,0x0F,0x00,
0xF0,0x00,0x60,0x00,0xE0,0x00,0x00,0x00,0x55,0x00,0xFF,0x00,0xF7,0x00,0x00,0x00,
0x6A,0x6A,0x41,0x41,0x6A,0x6A,0x43,0x43,0x6A,0x6A,0x42,0x42,0x6A,0x6A,0x42,0x42,
0x00,0x08,0x00,0x4A,0x00,0x52,0x00,0x53,0x00,0xA2,0x00,0xAA,0x00,0xD3,0x00,0xAE,
0x00,0x09,0x00,0x0A,0x00,0x2A,0x00,0x2C,0x00,0xF0,0x00,0x8D,0x00,0x5A,0x00,0xB5,
0x00,0x08,0x00,0x49,0x00,0x50,0x00,0x50,0x00,0xA6,0x00,0xAA,0x00,0xD5,0x00,0xAB,
0x2A,0x2A,0x00,0x00,0x00,0x00,0x00,0x50,0x00,0x20,0x00,0x60,0x01,0x91,0x03,0x63,
0xAA,0xAA,0x00,0x00,0xD0,0xD0,0xE8,0xE8,0xD0,0xD0,0xE8,0xE8,0xD4,0xD4,0xEE,0xEE,
0xA0,0xA0,0x00,0x00,0x00,0x00,0x00,0x00,0x00,0x00,0x00,0x00,0x00,0x00,0x00,0x00,
0x6C,0x6C,0x45,0x45,0x6E,0x6E,0x55,0x55,0x7A,0x7A,0x55,0x55,0x72,0x72,0x55,0x55,
0x7E,0x7E,0x55,0x55,0x76,0x76,0x55,0x55,0x46,0x46,0x55,0x55,0x70,0x70,0x55,0x55,
0x60,0x00,0x70,0x00,0x60,0x00,0x70,0x00,0x60,0x00,0x70,0x00,0x60,0x00,0xB0,0x00,
0x06,0x00,0x07,0x00,0x06,0x00,0x07,0x00,0x06,0x00,0x03,0x00,0x06,0x00,0x07,0x00,
0x6A,0x6A,0x41,0x41,0x6A,0x6A,0x41,0x41,0x6A,0x6A,0x42,0x42,0x6A,0x6A,0x41,0x41,
0x70,0x70,0xFD,0xFD,0xF7,0xF7,0x75,0x75,0xE3,0xE3,0xA0,0xA0,0x15,0x15,0x76,0x76,
0x38,0x38,0xDF,0xDF,0xDF,0xDF,0x7B,0x7B,0x52,0x52,0x8C,0x8C,0xD6,0xD6,0x54,0x54,
0xF4,0xF4,0x7C,0x7C,0x7D,0x7D,0xEF,0xEF,0x4B,0x4B,0x33,0x33,0x5B,0x5B,0x51,0x51,
0xC0,0xC0,0xF7,0xF7,0xDF,0xDF,0xD5,0xD5,0x8D,0x8D,0x82,0x82,0x57,0x57,0xD9,0xD9,
0x00,0x00,0x00,0x00,0x80,0x80,0xC0,0xC0,0xC1,0xC1,0xEF,0xEF,0xEF,0xEF,0xDE,0xDE,
0x00,0x00,0x00,0x00,0x00,0x00,0x00,0x00,0x80,0x80,0xC0,0xC0,0xE0,0xE0,0x60,0x60,
0x00,0x00,0x00,0x00,0x00,0xC1,0x00,0x21,0x00,0x22,0x00,0x12,0x00,0x12,0x00,0x4A,
0x06,0x00,0x07,0x00,0x06,0x00,0x07,0x00,0x06,0x00,0x0F,0x00,0x06,0x00,0x07,0x00,
0x6A,0x6A,0x41,0x41,0x6A,0x6A,0x42,0x42,0x6A,0x6A,0x42,0x42,0x6A,0x6A,0x40,0x40,
0xA0,0xA0,0xA0,0xA0,0xA4,0xA4,0x75,0x75,0xFF,0xFF,0xFF,0xFF,0xEE,0xEE,0xF0,0xF0,
0x08,0x08,0x01,0x01,0x08,0x08,0x81,0x81,0xC8,0xC8,0xE1,0xE1,0x68,0x68,0xA1,0xA1,
0x00,0x2A,0x00,0x2D,0x00,0x95,0x00,0xA4,0x00,0x48,0x00,0xA5,0x00,0xB7,0x00,0x5D,
